(no author) = No Author <openbabel-devel@lists.sourceforge.net>
annulen = Konstantin Tokarev <annulen@yandex.ru>
baoilleach = Noel O'Boyle <baoilleach@gmail.com>
benoitjacob = Benoit Jacob <jacob.benoit.1@gmail.com>
bherger = Brian Herger <bherger@users.sourceforge.net>
chrismorl = Chris Morley <c.morley@gaseq.co.uk>
cjames53 = Craig James <cjames@emolecules.com>
cniehaus = Carsten Niehaus <carsten.niehaus@gmail.com>
cryosuk = Marcus D. Hanwell <marcus@cryos.org>
dcurtis3 = Donald Ephraim Curtis <dcurtis3@sourceforge.net>
dleidert = Daniel Leidert <daniel.leidert.spam@gmx.net>
fabfont = Fabien Fontaine <ffontaine@gmail.com>
gert_thijs = Gert Thijs <gert.thijs@silicos.com>
ghutchis = Geoffrey Hutchison <geoff@geoffhutchison.net>
hansdewinter = Hans De Winter <hans@silicos-it.com>
hantek = Teng Lin <tlin@nd.edu>
jballanc = Joshua Ballanco <Joshua.Ballanco@stevens.edu>
jbrefort = Jean Brefort <jean.brefort@normalesup.org>
jensthomas = Jens Thomas <jensthomas@users.sourceforge.net>
jeremy_murphy = Jeremy Murphy <jeremy.william.murphy@gmail.com>
jiahao = Jiahao Chen <jiahao@mit.edu>
kebekus = Stephen Kebekus <stefan.kebekus@web.de>
kshepherd1 = Kevin Shepherd <scarletline@gmail.com>
magnuslundborg = Magnus Lundborg <lundborg.magnus@gmail.com>
mbanck = Michael Banck <mbanck@gmx.net>
mesprague = Matt Sprague <mesprague@gmail.com>
mr_grieves = David Lonie <loniedavid@gmail.com>
petermr = Peter Murray-Rust <pm286@cam.ac.uk>
pspendrin = Patrick Spendrin <ps_ml@gmx.de>
ptosco = Paolo Tosco <paolo.tosco@unito.it>
reg8 = Richard Gillilan <reg8@cornell.edu>
th9 = Reinis Danne <rei4dan@gmail.com>
timvdm = Tim Vandermeersch <tim.vandermeersch@gmail.com>
vincefn = Vincent Favre-Nicolin <vincefn@users.sourceforge.net>
wegner = Joerg Kurt Wegner <joerg.wegner@web.de>
